1122111232125451211111
1   1     1      1   1
2   1     1      1   1
1   11    1   1211   1
1              2     1
121    12311   1111111
1      1             1
2      1    1231111111
1                    1
2                    1
1112132311323131112211